11111111111111111111111111111111111111111111111111111111111111
1C0***C100C000M0000C000M000C00000000***00C**0C10000**0000000E1
100M*0*101111111111111111111100M00******01***01C0*****000M0011
111110*101100**0000000000000111111110***000*00100*00**11111111
1C00M000C100****00*0111C0000P00**0001**00M0000100M000*000*0001
11111111110**0**0**00011110000**00000*011111011111111**00**001
100C000C0100**00*00M00000011011000100*C1C*C1C110000C0*******01
1C00**0001C0*000001110001110001001010*C1C*C1C100C00000M**000C1
110***00C110**C0111000*0000C0C0010*010C1C*C1000011111111111111
100**0*01100*01000****0001111110***00C10**111111C00*000*0000C1
1000*M00M000000000****0001000M000*C00CC10***00C1C0***00**00M01
11111111111001100C0*0C001000111100M0001C00M00001C*****C1**1111
1C00000*0**01CC10000M0000001100*11111101111110001C0M0C1C0**001
100M00*0*001000111111111111C00C***0C00****0000M0011111111**001
11111110*0100*0*0*0*00M000C100M0*0110*00**00C11100M0000****001
1CCCCCC0*000*0*0*0*0111110001111110011110*0C111111111110****C1
1000M000M000M*0*M00*00M0000C000M0000C00M00C111C00M0000M00*00C1
11111111111111111111111111111111111111111111111111111111111111